%   %   %   %   %   %   %   %   %   %   %   %   %   %   %   %   %   %   %   %   %   %   %   %   %   %   %   %   %   %   %   
%   186 192 196 191 185 %   184 178 172 166 159 167 162 155 149 143 135 126 119 127 136 129 121 %   220 216 211 217 221 %   
%   180 %   %   %   179 %   190 %   %   %   153 %   %   %   %   %   %   %   111 %   %   %   113 %   218 212 207 213 219 %   
%   174 %   160 168 173 %   195 %   133 141 147 152 146 139 %   128 120 112 102 91  79  %   103 %   214 208 205 209 215 %   
%   169 161 154 %   %   %   198 %   124 %   %   %   %   131 %   137 %   %   %   %   69  80  92  %   %   %   204 206 210 %   
%   %   %   148 %   98  %   200 %   117 %   96  107 116 123 132 140 %   93  81  %   59  %   104 114 105 %   203 %   %   %   
%   125 134 142 %   85  %   %   %   108 %   83  %   %   %       %   %   %   70  %   50  %   %   %   94  %   202 201 199 %   
%   118 %   %   %   73  86  99  109 97  84  72  %                       %   60  51  44  52  61  71  82  %   %   %   197 %   
%   110 101 89  %   63  %   %   %   %   %   62  %   %   %   %   %   %   %   68  %   39  %   %   %   95  %   182 188 194 %   
%   %   %   76  %   54  46  41  %   30  %   53  45  40  35  %   38  43  49  58  %   34  %   122 115 106 %   176 %   %   %   
%   90  77  66  %   %   %   36  %   25  %   %   %   %   31  %   33  %   %   %   %   29  %   130 %   %   %   171 177 183 %   
%   78  67  57  48  42  37  32  %   20  15  12  16  21  26  %   28  23  18  14  19  24  %   138 145 151 158 165 %   189 %   
%   88  75  65  56  47  %   27  %   %   %   9   %   %   %   %   %   %   %   11  %   %   %   144 %   157 %   %   %   193 %   
%   100 87  74  64  55  %   22  17  13  10  7   5   3   1   P   2   4   6   8   %   163 156 150 %   164 170 175 181 187 %   
%   %   %   %   %   %   %   %   %   %   %   %   %   %   %   %   %   %   %   %   %   %   %   %   %   %   %   %   %   %   %   
COST: 222
# of Expanded Nodes: 442
Size of Frontiers: 2