%%%%%%%%%%%%%%%%%%%%%%%%%%%%%%%
%3630263137%384450566355606773798796103958693101%261151%
%42%%%43%32%%%69%%%%%%%111%%%109%4101593%
%48%625449%27%898175707683%94102110120131143%119%81417137%
%536168%%%24%98%%%%91%85%%%%153142130%%%181612%
%%%74%124%22%105%126115106999082%129141%163%118108117%19%%%
%978880%137%%%114%139%%% %%%152%172%%%128%202123%
%104%%%149136123113125138150%     %162171178170161151140%%%25%
%112121133%159%%%%%160%%%%%%%154%183%%%127%403428%
%%%146%168176181%192%169177182187%184179173164%188%100107116%46%%%
%132145156%%%186%197%%%%191%189%%%%193%92%%%514539%
%144155165174180185190%202207210206201196%194199204208203198%8477716457%33%
%134147157166175%195%%%213%%%%%%%211%%%78%65%%%29%
%122135148158167%2002052092122152172192210220218216214%596672%5852474135%
%%%%%%%%%%%%%%%%%%%%%%%%%%%%%%%
COST: 4267
# of Expanded Nodes: 447
Size of Frontiers: 227