%%%%%%%%%%%%%%%%%%%%%%%%%%%%%%%
%263440455156596264666872%%%%%706765636058544842373021%
%%%35%465257%%%717477797678757369%61%554943%31%%%
%121827%%%53%84%%%%81%80%%%%%%50%%%221410%
%8%1928364147%899497938883%828691959085%4438322315%6%
%4%%%29%%%%%100%%%%%%%98%%%39%24%%%%%
%2591320%879296991021041061080107105103101%172533%1611731%
%%%%%%%%%%%%%%%%%%%%%%%%%%%%%%%
COST: 1791
# of Expanded Nodes: 215
Size of Frontiers: 108