% % % % % % % % % % % % % % % % % % % % % % % % % % % % % % % % % % % % 
%                                                 . . . . . . . . . P % 
%   % % % % % % % % % % % % % % % % % % % % % % % . % % % % % % % %   % 
%   % %       %       %             % % % % % % % . . . % %           % 
%   % %   %   %   %   %   % % % %   % % % % % % % % % . % %   % % % % % 
%   % %   %   %   %   %                 . . . . . % % . % %           % 
%   % %   %   %   %   %   %   % % % %   . % % % . . . . % % % % % %   % 
%   %     %   %   %       %         % % . % % % % % % % %             % 
%   % %   %   %   % % % % % % % %   % % . . . . . . . . % %   % % % % % 
%   % %   %       % %               % % % % % % % % % . % %           % 
%         % % % % % %   % % % % % % %             % % . % % % % % %   % 
% % % % % %             %               % % % %   % % . %             % 
%             % % % % % %   % % % % %   %         % % . % %   % % % % % 
%   % % % % % %             %               % % % % % . % %           % 
%                 % % % % % %   % % % % % % % % % % % . % %     % %   % 
% % % % % % % % % % . . . . . . . . . . . . . . . . . . % % % % % %   % 
% 1 . . . . . . . . . % % % % % % % % % % % % % % % %                 % 
% % % % % % % % % % % % % % % % % % % % % % % % % % % % % % % % % % % % 
COST: 69
# of Expanded Nodes: 229
Size of Frontiers: 5