%%%%%%%%%%%%%%%%%%%%%%%%%%%%%%%
%&&&&&&&&&&&&%%%%%&&&&&&&&&&&&%
%%%&%&&&%%%&&&&&&&&&%&%&&&%&%%%
%&&&%%%&%&%%%%&%&%%%%%%&%%%&&&%
%&%&&&&&%&&&&&&%&&&&&&%&&&&&%&%
%&%%%&%%%%%&%%%%%%%&%%%&%&%%%%%
%&&&&&%&&&&&&&&&&&&&%&&&%&&&&&%
%%%%%%%%%%%%%%%%%%%%%%%%%%%%%%%
COST: 1791
# of Expanded Nodes: 215
Size of Frontiers: 108