%%%%%%%%%%%%%%%%%%%%%%%%%%%%%%%%%%%%
%                        .........&%
% %%%%%%%%%%%%%%%%%%%%%%%.%%%%%%%% %
% %%   %   %      %%%%%%%...%%     %
% %% % % % % %%%% %%%%%%%%%.%% %%%%%
% %% % % % %        .....%%.%%     %
% %% % % % % % %%%% .%%%....%%%%%% %
% %  % % %   %    %%.%%%%%%%%      %
% %% % % %%%%%%%% %%........%% %%%%%
% %% %   %%       %%%%%%%%%.%%     %
%    %%%%%% %%%%%%%      %%.%%%%%% %
%%%%%%      %       %%%% %%.%      %
%      %%%%%% %%%%% %    %%.%% %%%%%
% %%%%%%      %       %%%%%.%%     %
%        %%%%%% %%%%%%%%%%%.%%  %% %
%%%%%%%%%%..................%%%%%% %
%&.........%%%%%%%%%%%%%%%%        %
%%%%%%%%%%%%%%%%%%%%%%%%%%%%%%%%%%%%
COST: 68
# of Expanded Nodes: 229
Size of Frontiers: 232