%   %   %   %   %   %   %   %   %   %   %   %   %   %   %   %   %   %   %   %   %   %   %   %   %   %   %   %   %   %   %   
%   83  75  69  64  58  53  50  47  45  43  41  37  %   %   %   %   %   39  42  44  46  49  51  55  61  67  72  79  88  %   
%   %   %   74  %   63  57  52  %   %   %   38  35  32  30  33  31  34  36  40  %   48  %   54  60  66  %   78  %   %   %   
%   97  91  82  %   %   %   56  %   25  %   %   %   %   28  %   29  %   %   %   %   %   %   59  %   %   %   87  95  99  %   
%   101 %   90  81  73  68  62  %   20  15  12  16  21  26  %   27  23  18  14  19  24  %   65  71  77  86  94  %   103 %   
%   105 %   %   %   80  %   %   %   %   %   9   %   %   %   %   %   %   %   11  %   %   %   70  %   85  %   %   %   %   %   
%   107 104 100 96  89  %   22  17  13  10  7   5   3   1   P   2   4   6   8   %   92  84  76  %   93  98  102 106 108 %   
%   %   %   %   %   %   %   %   %   %   %   %   %   %   %   %   %   %   %   %   %   %   %   %   %   %   %   %   %   %   %   
COST: 109
# of Expanded Nodes: 216
Size of Frontiers: 1