%%%%%%%%%%%%%%%%%%%%%%
% %%        % %      %
%    %%%%%% % %%%%%% %
%%%%%%     &..%      %
%    % %%%%%%.%% %%%%%
% %%%% %    ..   %   %
%        %%%.%%%   % %
%%%%%%%%%%... %%%%%% %
%&.........%%        %
%%%%%%%%%%%%%%%%%%%%%%
COST: 19
# of Expanded Nodes: 54
Size of Frontiers: 58