%%%%%%%%%%%%%%%%%%%%
%2...........1416170.15%
%1%%3%%6%%10%%12%% %13%
% %% %45789      %11%
%%%%%%%%%%%%%%%%%%%%
COST: 114
# of Expanded Nodes: 53
Size of Frontiers: 37