% % % % % % % % % % % % % % % % % % % % % % 
%   % %                 %   %             % 
%         % % % % % %   %   % % % % % %   % 
% % % % % %           P . . %             % 
%         %   % % % % % % . % %   % % % % % 
%   % % % %   %         . .       %       % 
%                 % % % . % % %       %   % 
% % % % % % % % % % . . .   % % % % % %   % 
% 1 . . . . . . . . . % %                 % 
% % % % % % % % % % % % % % % % % % % % % % 
COST: 20
# of Expanded Nodes: 54
Size of Frontiers: 59