%%%%%%%%%%%%%%%%%%%%
%&...........&&&&.&%
%&%%&%%&%%&%%&%% %&%
% %% %&&&&&      %&%
%%%%%%%%%%%%%%%%%%%%
COST: 114
# of Expanded Nodes: 53
Size of Frontiers: 37