%%%%%%%%%%%%%%%%%%%%%%
% %%        % %      %
%    %%%%%% % %%%%%% %
%%%%%%     0..%      %
%    % %%%%%%.%% %%%%%
% %%%% %    ..   %   %
%        %%%.%%%   % %
%%%%%%%%%%... %%%%%% %
%1.........%%        %
%%%%%%%%%%%%%%%%%%%%%%
COST: 19
# of Expanded Nodes: 57
Size of Frontiers: 60