%  %  %  %  %  %  %  %  %  %  %  %  %  %  %  %  %  %  %  %  
%  16 .  .  .  .  .  .        .  .  .  3  2  1  P  .  5  %  
%  17 %  %  15 %  %  13 %  %  8  %  %  4  %  %     %  6  %  
%     %  %     %  14 12 11 10 9                    %  7  %  
%  %  %  %  %  %  %  %  %  %  %  %  %  %  %  %  %  %  %  %  
COST: 32
# of Expanded Nodes: 53
Size of Frontiers: 2