%  %  %  %  %  %  %  %  %  %  %  %  %  %  %  %  %  %  %  %  
%  7  .  .  .  .  .  .        .  .  .  3  5  %  .  .  .  %  
%  8  %  %  6  %  %  2  %  %  1  %  %  4  %  %  .  %  .  %  
%                    .  .  P  .        .  .  .  .  %  .  %  
%  %  %  %  %  %  %  %  %  %  %  %  %  %  %  %  %  %  .  %  
%  13 12 11 10 9  .  .  .  .  .  .  .  .  .  .  .  .  .  %  
%  %  %  %  %  %  %  %  %  %  %  %  %  %  %  %  %  %  %  %  
COST: 54
# of Expanded Nodes: 72
Size of Frontiers: 1