%  %  %  %  %  %  %  %  %  %  %  %  %  %  %  %  %  %  %  %  
%  8        .  .  .  .        .  .  .  3  5  %  .  .  .  %  
%  7  %  %  6  %  %  2  %  %  1  %  %  4  %  %  .  %  .  %  
%  .  .  .  .        .  .  P  .        .  .  .  .  %  .  %  
%  %  %  %  %  %  %  %  %  %  %  %  %  %  %  %  %  %  .  %  
%  13 12 11 10 9  .  .  .  .  .  .  .  .  .  .  .  .  .  %  
%  %  %  %  %  %  %  %  %  %  %  %  %  %  %  %  %  %  %  %  
COST: 52
# of Expanded Nodes: 72
Size of Frontiers: 1