%%%%%%%%%%%%%%%%%%%%
%6           108%...%
%7%%9%%12%%13%%11%%.%.%
%........0.......%.%
%%%%%%%%%%%%%%%%%%.%
%12345.............%
%%%%%%%%%%%%%%%%%%%%
COST: 186
# of Expanded Nodes: 72
Size of Frontiers: 59