%%%%%%%%%%%%%%%%%%%%
%&           &&%...%
%&%%&%%&%%&%%&%%.%.%
%........&.......%.%
%%%%%%%%%%%%%%%%%%.%
%&&&&&.............%
%%%%%%%%%%%%%%%%%%%%
COST: 186
# of Expanded Nodes: 72
Size of Frontiers: 59